#####
# #K#
#O  #
# D #
#####
